@ * . . . *
. . * . . .
. . . . . .
. . * . * .
. . . * * .