@ * . . . *
. . * . . .
. . . . . .
. . * . . .
. * . . . .